269 268 268 268 268 268 268 268 268 268 268 268 268 268 268 268 268 268 268 268 268 268 268 268 268 268 268 268 268 268 268 268 268 268 268 268 268 268 268 268 268 268 268 268 268 268 268 268 268 268 268 268 268 268 268 268 268 268 268 268 268 268 268 268 268 268 268 268 268 267
266 265 265 265 265 265 265 265 265 265 265 265 265 265 265 265 265 265 265 265 265 265 265 265 265 265 265 265 265 265 265 265 265 265 265 265 265 265 265 265 265 265 265 265 265 265 265 265 265 265 265 265 265 270 270 270 265 265 265 265 265 265 265 265 265 265 265 265 265 264
266 265 265 265 265 265 265 265 265 265 265 265 265 265 265 265 265 265 265 265 265 265 265 265 265 265 265 265 265 265 265 265 265 265 265 265 265 265 265 265 265 265 265 265 265 265 265 265 265 265 265 265 265 270 270 270 265 265 265 265 265 265 265 265 265 265 265 265 265 264
258 262 262 262 262 262 262 262 262 262 262 262 262 262 262 262 262 262 262 262 262 262 262 262 262 262 262 262 262 262 262 262 262 262 262 262 262 262 262 262 262 262 262 262 262 262 262 262 262 262 262 262 262 262 260 262 262 262 262 262 262 262 262 262 262 262 262 262 262 258
258 2 1 1 1 1 1 1 1 1 1 1 1 1 1 1 1 1 1 1 1 1 1 1 1 1 1 1 1 1 1 1 1 1 1 1 1 1 1 1 1 1 1 1 1 1 1 1 1 1 1 1 1 273 276 279 1 1 1 1 62 63 64 1 1 1 1 1 52 258
258 2 1 1 1 77 76 1 77 76 77 76 1 1 1 1 1 1 1 1 1 1 1 1 1 1 1 1 1 70 71 1 1 1 1 55 58 1 1 1 1 1 1 1 55 58 1 1 1 1 1 1 1 273 276 279 1 1 1 1 65 66 67 1 1 1 1 1 52 258
258 2 1 1 1 74 75 1 74 75 74 75 1 1 1 1 1 1 1 1 1 1 1 1 1 1 1 1 1 68 69 1 1 1 127 128 129 55 58 1 1 55 58 127 128 129 1 1 1 1 1 55 58 273 276 279 55 58 1 1 1 1 1 1 1 1 1 1 52 258
48 46 47 275 275 275 275 275 275 275 275 275 278 1 1 1 1 1 1 1 1 1 1 1 1 1 1 1 1 1 1 1 1 1 124 125 126 56 59 1 1 56 59 124 125 126 1 1 1 1 1 56 59 273 276 279 56 59 1 1 37 38 39 1 1 1 1 1 52 258
46 47 48 276 276 276 276 276 276 276 276 276 279 1 1 1 1 1 1 1 1 1 1 1 1 1 1 1 1 70 71 1 1 1 121 122 123 57 1 1 1 57 1 121 122 123 1 1 1 1 1 57 1 273 276 279 57 1 1 1 40 41 42 1 1 1 1 1 52 258
46 47 49 274 89 92 95 274 274 274 273 276 279 1 89 92 95 1 1 1 89 92 95 1 1 1 1 1 1 68 69 1 1 1 118 119 120 130 131 131 131 131 132 118 119 120 1 1 1 1 1 1 1 273 276 279 1 1 1 1 43 44 45 1 1 1 1 1 52 258
258 2 1 1 90 93 96 1 1 1 273 276 279 1 90 93 96 1 1 1 90 93 96 1 1 1 1 1 1 1 1 1 1 1 115 116 117 133 134 134 134 134 135 115 116 117 1 1 1 1 1 1 1 273 276 279 89 92 95 1 1 89 92 95 1 89 92 95 52 258
258 2 1 1 91 94 1 1 1 1 273 276 279 1 91 94 1 1 1 1 91 94 1 1 1 1 1 1 1 70 71 1 1 1 112 113 114 136 137 137 137 137 138 112 113 114 1 1 1 1 1 1 1 273 276 279 90 93 96 1 1 90 93 96 1 90 93 96 52 258
258 2 1 1 1 1 1 1 1 1 273 276 279 1 1 1 1 1 1 1 1 1 1 1 1 1 1 1 1 68 69 1 1 1 106 107 108 1 1 1 1 1 1 106 107 108 1 1 1 1 1 1 1 273 276 279 91 94 1 1 1 91 94 1 1 91 94 1 52 258
258 2 1 1 89 92 95 1 1 1 273 276 279 1 1 1 1 1 1 1 1 1 1 1 1 1 1 1 1 1 1 1 1 1 110 109 111 1 1 1 1 1 1 110 109 111 1 1 1 1 1 1 1 273 276 279 1 1 1 1 1 1 1 1 1 1 1 1 52 258
258 2 1 1 90 93 96 1 1 1 273 276 279 1 89 92 95 1 1 1 89 92 95 1 1 1 89 92 95 1 1 1 1 1 37 38 39 1 1 37 38 39 1 1 37 38 39 1 1 1 1 1 1 273 276 279 1 1 1 89 92 95 1 1 89 92 95 1 52 258
258 2 1 1 91 94 1 1 1 1 273 276 279 1 90 93 96 1 1 1 90 93 96 1 1 1 90 93 96 1 1 1 1 1 40 41 42 1 1 40 41 42 1 1 40 41 42 1 1 1 1 1 1 273 276 279 1 1 1 90 93 96 1 1 90 93 96 1 52 258
258 2 1 1 1 1 1 1 1 1 273 276 279 1 91 94 1 1 1 1 91 94 1 1 1 1 91 94 1 1 1 1 1 1 43 44 45 1 1 43 44 45 1 1 43 44 45 1 1 1 1 1 1 273 276 279 1 1 1 91 94 1 1 1 91 94 1 1 52 258
258 2 1 1 89 92 95 1 1 1 273 276 279 1 1 1 1 1 1 1 1 1 1 1 1 1 1 1 1 1 1 1 1 1 1 1 1 1 1 1 1 1 1 1 1 1 1 1 1 1 1 1 1 273 276 279 1 1 1 1 1 1 1 1 1 1 1 1 52 258
258 2 1 1 90 93 96 1 1 1 273 276 276 276 276 276 276 276 276 276 276 276 276 276 276 276 276 276 276 276 276 276 276 276 276 276 276 276 276 276 276 276 276 276 276 276 276 276 276 276 276 276 276 276 276 279 1 1 1 1 1 1 1 1 1 1 1 1 52 258
258 2 1 1 91 94 1 1 1 1 274 277 277 277 277 277 277 277 277 277 277 277 277 277 277 277 277 277 277 277 277 277 277 277 277 277 277 277 277 277 277 277 277 277 277 277 277 277 277 277 277 277 277 277 277 280 1 1 1 1 1 1 1 1 1 1 1 1 52 258
258 282 53 53 53 53 53 53 53 53 53 53 53 53 53 53 53 53 53 53 53 53 53 53 53 53 53 53 53 53 53 53 53 53 53 53 53 53 53 53 53 53 53 53 53 53 53 53 53 53 53 53 53 53 53 53 53 53 53 53 53 53 53 53 53 53 53 53 283 258
258 258 258 258 258 258 258 258 258 258 258 258 258 258 258 258 258 258 258 258 258 258 258 258 258 258 258 258 258 258 258 258 258 258 258 258 258 258 258 258 258 258 258 258 258 258 258 258 258 258 258 258 258 258 258 258 258 258 258 258 258 258 258 258 258 258 258 258 258 258




