50 50 188 46 193 48 188 50 50 50 50 50 50 50 50 50 50 50 50 50 50 50 50 50 50 50 50 50 50 50 50 50
50 50 188 48 192 47 188 50 50 50 50 50 50 50 50 50 50 50 50 50 50 50 50 50 50 50 50 50 50 50 50 50
50 50 188 47 192 46 188 50 50 50 50 50 50 50 50 50 50 50 50 50 50 50 50 50 50 50 50 50 50 50 50 50
50 188 47 48 271 48 47 46 188 50 50 50 50 50 50 50 50 50 50 50 50 50 50 50 50 50 50 50 50 50 50 50
50 50 188 48 191 48 47 46 47 188 50 50 50 50 50 50 50 50 50 50 50 50 50 50 50 50 50 50 50 50 50 50
50 50 50 188 51 51 194 195 196 51 188 50 50 50 50 50 50 50 50 50 50 50 50 50 50 50 50 50 50 50 50 50
50 50 50 50 188 51 197 198 199 51 51 51 188 50 50 50 50 50 50 50 50 50 50 50 50 50 50 50 50 50 50 50
50 50 50 50 50 188 200 201 202 51 51 51 51 188 50 50 50 50 50 50 50 50 50 50 50 50 50 50 50 50 50 50
50 50 50 50 50 50 188 51 51 51 51 51 51 51 188 50 50 50 50 50 50 50 50 50 50 50 50 50 50 50 50 50
50 50 50 50 50 50 50 188 51 51 51 51 51 51 51 188 50 50 50 50 50 50 50 50 50 50 50 50 50 50 50 50
50 50 50 50 50 50 50 50 188 51 51 51 51 51 51 51 188 50 50 50 50 50 50 50 50 50 50 50 50 50 50 50
50 50 50 50 50 50 50 50 50 188 189 51 51 51 51 51 51 189 188 50 50 50 50 50 50 50 50 50 50 50 50 50
50 50 50 50 50 50 50 50 50 188 190 51 51 51 51 51 51 190 188 50 50 50 50 50 50 50 50 50 50 50 50 50
50 50 50 50 50 50 50 50 50 188 51 51 51 51 51 51 51 51 188 50 50 50 50 50 50 50 50 50 50 50 50 50
50 50 50 50 50 50 50 50 50 50 188 51 51 51 194 195 196 188 50 50 50 50 50 50 50 50 50 50 50 50 50 50
50 50 50 50 50 50 50 50 50 50 188 51 51 51 197 198 199 188 50 50 50 50 50 50 50 50 50 50 50 50 50 50
50 50 50 50 50 50 50 50 50 188 51 51 51 51 200 201 202 188 50 50 50 50 50 50 50 50 50 50 50 50 50 50
50 50 50 50 50 50 50 50 188 51 51 51 51 51 51 51 188 50 50 50 50 50 50 50 50 50 50 50 50 50 50 50
50 50 50 50 50 50 50 188 51 51 51 51 51 51 51 188 50 50 50 50 50 50 50 50 50 50 50 50 50 50 50 50
50 50 50 50 50 50 188 189 51 51 51 51 51 189 188 50 50 50 50 50 50 50 50 50 50 50 50 50 50 50 50 50
50 50 50 50 50 50 188 190 51 51 51 51 51 190 188 50 50 50 50 50 50 50 50 50 50 50 50 50 50 50 50 50
50 50 50 50 50 50 50 188 51 51 51 51 51 51 51 188 50 50 50 50 50 50 50 50 50 50 50 50 50 50 50 50
50 50 50 50 50 50 50 50 50 188 51 51 51 51 51 51 188 50 50 50 50 50 50 50 50 50 50 50 50 50 50 50
50 50 50 50 50 50 50 50 50 50 188 51 51 51 51 51 188 50 50 50 50 50 50 50 50 50 50 50 50 50 50 50
50 50 50 50 50 50 50 50 50 50 50 188 51 51 51 51 51 188 50 50 50 50 50 50 50 50 50 50 50 50 50 50
50 50 50 50 50 50 50 50 50 50 50 50 188 51 51 51 51 51 188 50 50 50 50 50 50 50 50 50 50 50 50 50
50 50 50 50 50 50 50 50 50 50 50 50 50 188 189 51 51 51 51 188 188 188 188 188 188 188 188 188 188 188 188 188
50 50 50 50 50 50 50 50 50 50 50 50 50 188 190 194 195 196 51 51 51 51 51 51 51 51 51 51 51 51 51 188
50 50 50 50 50 50 50 50 50 50 50 50 50 188 189 197 198 199 51 51 51 51 51 51 51 51 51 51 51 51 51 188
50 50 50 50 50 50 50 50 50 50 50 50 50 188 190 200 201 202 51 51 51 51 51 51 51 51 51 51 51 47 46 188
50 50 50 50 50 50 50 50 50 50 50 50 50 188 188 188 188 188 188 188 188 188 188 188 188 188 188 188 188 48 49 188
50 50 50 50 50 50 50 50 50 50 50 50 50 50 50 50 50 50 50 50 50 50 50 50 50 50 50 50 50 50 50 50
