241 242 241 242 241 242 241 242 241 242 241 242 242 241 242 241 242 241 242 241 242 241 242 242 241 242 241 241 242
236 88 88 88 88 88 88 88 88 88 88 88 88 88 88 88 88 88 88 88 88 88 88 88 88 88 88 88 236
235 88 88 88 88 88 88 88 88 88 88 88 88 88 88 88 88 88 88 88 88 88 88 88 88 88 88 88 235
236 218 220 88 88 88 88 88 88 88 88 88 88 88 88 88 88 88 88 88 88 88 88 88 88 218 220 88 236
235 219 221 88 88 88 88 88 88 88 88 88 88 88 88 88 88 88 88 88 88 88 88 88 88 219 221 88 235
236 88 88 88 88 88 88 88 88 88 88 88 88 88 88 88 88 88 88 88 88 88 88 88 88 88 88 88 236
235 218 220 88 88 88 88 88 88 88 88 88 88 88 88 88 88 88 88 88 88 88 88 88 88 218 220 88 235
236 219 221 88 88 88 88 88 88 88 88 88 88 88 88 88 88 88 88 88 88 88 88 88 88 219 221 88 236
235 88 88 88 88 88 88 88 88 88 88 88 88 88 88 88 88 88 88 88 88 88 88 88 88 88 88 88 235
236 218 220 88 88 88 88 88 88 88 88 88 88 88 88 88 88 88 88 88 88 88 88 88 88 218 220 88 236
235 219 221 88 88 88 88 88 88 88 88 88 88 88 88 88 88 88 88 88 88 88 88 88 88 219 221 88 235
236 88 88 88 216 88 88 216 88 88 214 88 88 88 88 88 216 88 88 214 88 88 216 88 88 88 88 88 236
235 88 88 88 217 88 88 217 88 88 215 281 88 88 88 281 217 88 88 215 88 88 217 88 88 88 88 88 235
238 1 1 1 1 1 1 1 1 1 1 204 88 88 88 204 1 1 1 1 1 1 1 1 1 1 1 1 238
237 1 205 206 207 205 206 207 205 206 207 203 88 88 88 203 205 206 207 205 206 207 205 206 207 1 1 1 237
238 1 208 209 210 208 209 210 208 209 210 204 88 88 88 204 208 209 210 208 209 210 208 209 210 1 1 1 238
237 1 211 212 213 211 212 213 211 212 213 203 48 47 49 203 211 212 213 211 212 213 211 212 213 1 1 1 237
238 1 1 1 1 1 1 1 1 1 1 204 49 48 47 204 1 1 1 1 1 1 1 1 1 1 1 1 238
239 240 239 240 239 240 239 240 239 240 239 240 49 48 47 239 240 239 240 239 240 239 240 239 240 239 240 239 237
