258 258 258 258 258 258 258 258 258 258 258 258 258 258 258 258 258 258 258 258 258 258 258 258 258 258 258 258 258 258 258 258
258 262 262 262 262 262 262 262 262 262 262 262 262 262 262 262 262 262 262 262 262 262 262 262 262 262 262 262 262 262 262 262
258 2 1 1 1 97 1 1 1 1 1 1 1 97 1 1 1 1 97 1 1 1 1 97 1 1 1 1 1 1 52 258
258 2 1 1 89 92 95 1 1 1 1 1 89 92 95 1 1 89 92 95 1 1 89 92 95 1 1 1 1 1 52 258
258 2 1 1 90 93 96 1 1 1 1 1 90 93 96 1 1 90 93 96 1 1 90 93 96 1 1 1 1 1 52 258
258 2 1 1 91 94 1 1 1 1 1 1 91 94 1 1 1 91 94 1 1 1 91 94 1 1 1 1 1 1 52 258
258 2 1 1 1 1 1 1 1 272 275 275 275 275 275 275 275 275 275 275 275 275 275 275 275 275 275 275 275 48 46 47
258 2 1 1 1 1 1 1 1 273 276 276 276 276 276 276 276 276 276 276 276 276 276 276 276 276 276 276 276 46 47 48
258 2 1 1 1 97 1 1 1 273 276 277 277 277 277 277 277 277 277 277 277 277 277 277 277 277 277 277 277 49 48 46
258 2 1 1 89 92 95 1 1 273 276 279 284 285 285 285 285 285 285 285 285 285 285 285 285 285 285 285 285 286 52 258
258 2 1 1 90 93 96 1 1 273 276 279 287 288 288 288 288 288 288 288 288 288 288 288 288 288 288 288 288 289 52 258
258 2 1 1 91 94 1 1 1 273 276 279 287 288 100 101 288 288 288 288 100 101 288 288 288 288 100 101 288 289 52 258
258 2 1 1 1 1 1 1 1 273 276 279 287 288 102 103 288 288 288 288 102 103 288 288 288 288 102 103 288 289 52 258
258 2 1 1 1 97 1 1 1 273 276 279 287 288 288 288 288 288 288 288 288 288 288 288 288 288 288 288 288 289 52 258
258 2 1 1 89 92 95 1 1 273 276 279 287 288 100 101 288 288 288 288 100 101 288 288 288 288 100 101 288 289 52 258
258 2 1 1 90 93 96 1 1 273 276 279 287 288 102 103 288 288 288 288 102 103 288 288 288 288 102 103 288 289 52 258
258 2 1 1 91 94 1 1 1 273 276 279 287 288 288 288 288 288 288 288 288 288 288 288 288 288 288 288 288 289 52 258
49 47 46 275 275 275 275 275 275 275 276 279 287 288 288 288 288 288 288 288 288 288 288 288 288 288 288 288 288 289 52 258
48 46 47 276 276 276 276 276 276 276 276 279 287 288 288 288 288 288 288 288 288 288 288 288 288 288 288 288 288 289 52 258
46 47 48 277 277 277 277 277 277 277 277 280 290 291 291 291 291 291 291 291 291 291 291 291 291 291 291 291 291 292 52 258
258 282 53 53 53 53 53 53 53 53 53 53 53 53 53 53 53 53 53 53 53 53 53 53 53 53 53 53 53 53 283 258
258 258 258 258 258 258 258 258 258 258 258 258 258 258 258 258 258 258 258 258 258 258 258 258 258 258 258 258 258 258 258 258

