258 258 258 258 258 258 258 258 258 258 258 258 258 258 258 258 258 258 258 258 258 258 258 258 258 258 258 258 258 258 258 258
258 262 262 262 262 262 262 262 262 262 262 262 262 262 262 262 262 262 262 262 262 262 262 262 262 262 262 262 262 262 262 262
258 2 1 1 1 1 1 1 1 1 1 1 1 97 1 1 1 1 97 1 1 1 1 97 1 1 1 1 1 1 52 258
258 2 1 1 1 1 1 1 1 1 1 1 89 92 95 1 1 89 92 95 1 1 89 92 95 1 1 1 1 1 52 258
258 2 1 1 1 1 1 1 1 1 1 1 90 93 96 1 1 90 93 96 1 1 90 93 96 1 1 1 1 1 52 258
258 2 1 1 1 1 1 1 1 1 1 1 91 94 1 1 1 91 94 1 1 1 91 94 1 1 1 1 1 1 52 258
49 47 46 275 275 275 275 275 275 275 275 278 1 1 1 1 1 1 1 1 1 1 1 272 275 275 275 275 275 48 46 47
48 46 47 276 276 276 276 276 276 276 276 279 1 1 1 1 1 1 1 1 1 1 1 273 276 276 276 276 276 46 47 48
46 47 48 277 277 277 277 277 277 277 276 279 1 1 1 1 1 1 1 1 1 1 1 273 276 279 277 277 277 49 48 46
258 2 1 1 1 1 1 1 1 273 276 279 1 1 1 1 1 1 1 1 1 1 73 273 276 279 73 1 1 1 52 258
258 2 1 1 1 1 1 1 1 273 276 279 1 1 1 1 1 1 1 1 1 1 72 273 276 279 72 1 1 1 52 258
258 2 1 1 97 1 1 1 1 273 276 279 1 1 1 1 1 1 1 1 1 1 1 273 276 279 1 1 1 1 52 258
258 2 1 89 92 95 1 1 1 273 276 279 1 1 1 1 1 1 1 1 1 1 73 273 276 279 73 1 1 1 52 258
258 2 1 90 93 96 1 1 1 273 276 279 1 1 1 1 1 1 1 1 1 1 72 273 276 279 72 1 1 1 52 258
258 2 1 91 94 1 1 1 1 273 276 279 1 77 76 1 1 77 76 1 1 1 1 273 276 279 1 1 1 1 52 258
258 2 1 1 1 1 1 1 1 273 276 279 1 74 75 1 1 74 75 1 1 1 73 273 276 279 73 1 1 1 52 258
258 2 1 1 97 1 1 1 1 273 276 279 1 77 76 1 1 77 76 1 1 1 72 273 276 279 72 1 1 1 52 258
258 2 1 89 92 95 1 1 1 273 276 279 1 74 75 1 1 74 75 1 1 1 1 273 276 279 1 1 1 1 52 258
258 2 1 90 93 96 1 1 1 273 276 276 276 276 276 276 276 276 276 276 276 276 276 276 276 279 1 1 1 1 52 258
258 2 1 91 94 1 1 1 1 274 277 277 277 277 277 277 277 277 277 277 277 277 277 277 277 280 1 1 1 1 52 258
258 282 53 53 53 53 53 53 53 53 53 53 53 53 53 53 53 53 53 53 53 53 53 53 53 53 53 53 53 53 283 258
258 258 258 258 258 258 258 258 258 258 258 258 258 258 258 258 258 258 258 258 258 258 258 258 258 258 258 258 258 258 258 258


