32 32 32 32 32 32 32 32 32 32 32 32 32 32 32 32 32 32 32 32 32 32 32 32 32 32 32 32 32 32 32 32
32 252 35 35 35 35 35 35 35 35 35 35 35 35 35 35 35 35 35 35 35 35 35 35 35 35 35 35 35 35 253 32
32 33 1 1 1 1 1 1 1 1 1 1 1 1 1 1 1 1 1 1 1 1 1 1 1 1 1 1 1 1 31 32
32 33 1 97 1 1 1 1 1 1 1 1 1 1 1 1 1 1 1 97 1 1 1 1 1 1 1 1 1 1 31 32
32 33 89 92 95 1 1 1 1 1 1 1 23 24 25 26 27 1 89 92 95 1 1 1 62 63 64 1 1 1 31 32
32 33 90 93 96  1 1 1 1 1 1 1 18 19 20 21 22 1 90 93 96 1 1 1 65 66 67 1 1 1 31 32
32 33 91 94 1 1  1 1 1 1 1 1 13 14 15 16 17 1 91 94 1 1 1 1 1 1 1 1 1 1 31 32
32 33 1 70 71 1 1 1 1 1 1 73 8 9 10 11 12 73 1 1 1 1 1 1 37 38 39 1 1 1 31 32
32 33 1 68 69 1 1 1 1 1 1 72 3 4 5 6 7 72 1 1 1 1 1 1 40 41 42 1 1 1 31 32
32 33 1 1 1 1 1 1 1 1 1 1 1 273 276 279 1 1 1 1 1 1 1 1 43 44 45 1 1 1 31 32
32 33 1 28 29 29 29 30 1 1 1 1 1 273 276 279 1 1 1 1 1 1 1 1 1 1 1 1 1 1 31 32
32 33 1 31 32 32 32 33 1 1 1 1 1 273 276 279 1 1 1 1 1 1 1 1 1 1 1 1 1 1 31 32
32 33 1 31 32 32 32 33 1 1 1 1 1 273 276 279 1 1 1 1 1 1 1 1 1 1 1 1 1 1 31 32
32 33 1 34 35 35 35 36 1 1 1 1 1 273 276 279 1 1 1 1 1 1 1 1 87 1 1 1 1 1 31 32
32 33 1 70 71 1 1 1 1 1 1 1 1 273 276 279 1 1 1 1 1 1 1 1 86 1 1 78 79 1 31 32
32 33 1 68 69 1 1 1 1 1 1 1 1 273 276 279 1 1 1 1 1 1 1 1 85 1 1 80 81 1 31 32
32 33 1 1 1 1 1 1 1 1 1 1 1 273 276 279 1 1 1 1 1 1 1 1 84 1 1 82 83 1 31 32
32 33 1 77 76 77 76 1 1 1 1 55 58 273 276 279 1 55 58 1 1 1 1 1 1 1 1 1 1 1 31 32
32 33 1 74 75 74 75 1 1 1 1 56 59 273 276 279 1 56 59 1 1 1 1 1 1 1 1 1 1 1 31 32
32 33 1 1 1 1 1 1 1 1 1 57 1 273 276 279 1 57 1 1 1 1 1 1 1 1 1 1 1 1 31 32
32 255 29 29 29 29 29 29 29 29 29 29 222 223 223 223 224 29 29 29 29 29 29 29 29 29 29 29 29 29 256 32
32 32 32 32 32 32 32 32 32 32 32 32 225 226 226 226 227 32 32 32 32 32 32 32 32 32 32 32 32 32 32 32



