32 32 32 32 32 32 32 32 32 32 32 32 225 226 226 226 227 32 32 32 32 32 32 32 32 32 32 32 32 32 32 32
32 32 32 32 32 32 32 32 32 32 32 32 225 226 226 226 227 32 32 32 32 32 32 32 32 32 32 32 32 32 32 32
32 32 32 32 32 32 32 32 32 32 32 32 225 226 226 226 227 32 32 32 32 32 32 32 32 32 32 32 32 32 32 32
35 35 35 35 35 35 35 35 35 35 35 35 228 229 229 229 230 35 35 35 35 35 35 35 35 35 35 35 35 35 35 35
258 2 1 97 1 1 97 1 1 97 1 1 1 273 276 279 1 1 1 1 1 1 1 1 1 97 1 1 97 1 52 258
258 2 89 92 95 89 92 95 89 92 95 1 1 273 276 279 1 1 1 1 1 1 1 1 89 92 95 89 92 95 52 258
258 2 90 93 96 90 93 96 90 93 96 1 1 273 276 279 1 1 1 1 1 1 70 71 90 93 96 90 93 96 52 258
258 2 91 94 1 91 94 1 91 94 1 1 1 273 276 279 1 1 1 1 1 1 68 69 91 94 1 91 94 1 52 258
258 2 1 1 1 1 1 1 1 1 1 1 1 273 276 279 1 1 1 1 1 1 1 1 1 97 1 1 97 1 52 258
258 2 1 1 275 275 275 275 275 275 275 275 275 275 276 279 1 1 1 1 1 1 1 1 89 92 95 89 92 95 52 258
258 2 1 273 276 276 276 276 276 276 276 276 276 276 276 279 1 1 1 1 1 1 1 1 90 93 96 90 93 96 52 258
258 2 1 273 276 277 277 97 277 277 97 277 277 97 277 1 97 1 284 285 285 285 285 286 91 94 1 91 94 1 52 258
258 2 1 273 276 279 89 92 95 89 92 95 89 92 95 89 92 95 287 288 288 288 288 289 1 1 1 1 1 1 52 258
258 2 1 273 276 279 90 93 96 90 93 96 90 93 96 90 93 96 287 288 288 288 288 289 1 1 1 1 1 1 52 258
258 2 1 273 276 279 91 94 1 91 94 1 91 94 1 91 94 1 287 288 288 288 288 289 1 1 1 1 55 58 52 258
258 2 1 273 276 279 1 70 71 1 1 70 71 1 1 70 71 1 287 288 288 288 288 289 1 1 1 1 56 59 52 258
258 2 1 273 276 279 1 68 69 1 1 68 69 1 1 68 69 1 290 291 291 291 291 292 1 1 1 1 57 1 52 258
258 2 1 273 276 275 275 275 275 275 275 275 275 275 275 275 275 275 275 275 275 275 275 275 275 275 275 275 49 48 47 46
258 2 1 273 276 276 276 276 276 276 276 276 276 276 276 276 276 276 276 276 276 276 276 276 276 276 276 276 46 49 46 47
258 2 1 1 277 277 277 277 277 277 277 277 277 277 277 277 277 277 277 277 277 277 277 277 277 277 277 277 46 49 46 47
258 282 53 53 53 53 53 53 53 53 53 53 53 53 53 53 53 53 53 53 53 53 53 53 53 53 53 53 53 53 283 258
258 258 258 258 258 258 258 258 258 258 258 258 258 258 258 258 258 258 258 258 258 258 258 258 258 258 258 258 258 258 258 258




