50 50 50 50 50 50 50 50 50 50 50 50 50 50 50 50 50 50 50 50 50 50 50 50 50 50 50 50 50 50 50 50
50 50 50 50 50 50 50 50 50 181 181 181 181 181 181 181 181 181 181 181 181 50 50 50 50 50 50 50 50 50 50 50
50 50 50 50 50 50 50 50 50 181 181 181 181 181 181 181 181 181 181 181 181 50 50 50 50 50 50 50 50 50 50 50
50 50 50 50 50 50 50 50 50 181 157 158 182 183 181 186 187 148 149 150 181 50 50 50 50 50 50 50 50 50 50 50
50 50 50 50 50 50 50 50 50 181 159 160 181 181 181 181 181 151 152 153 181 50 50 50 50 50 50 50 50 50 50 50
50 50 50 50 50 50 50 50 50 181 161 162 139 139 139 139 139 154 155 156 181 50 50 50 50 50 50 50 50 50 50 50
50 50 50 50 50 50 50 50 50 181 139 139 139 139 139 139 139 139 139 139 181 50 50 50 50 50 50 50 50 50 50 50
50 50 50 50 50 50 50 50 50 181 139 139 139 139 142 139 147 139 139 139 181 50 50 50 50 50 50 50 50 50 50 50
50 50 50 50 50 50 50 50 50 181 139 139 139 139 141 144 146 139 139 139 181 50 50 50 50 50 50 50 50 50 50 50
50 50 50 50 50 50 50 50 50 181 139 139 139 139 140 143 145 139 139 139 181 50 50 50 50 50 50 50 50 50 50 50
50 50 50 50 50 50 50 50 50 181 139 139 139 139 139 139 139 139 139 139 181 50 50 50 50 50 50 50 50 50 50 50
50 50 50 50 50 50 50 50 50 181 139 139 172 176 176 176 176 180 139 139 181 50 50 50 50 50 50 50 50 50 50 50
50 50 50 50 50 50 50 50 50 181 166 163 171 175 175 175 175 179 166 163 181 50 50 50 50 50 50 50 50 50 50 50
50 50 50 50 50 50 50 50 50 181 167 164 170 174 174 174 174 178 167 164 181 50 50 50 50 50 50 50 50 50 50 50
50 50 50 50 50 50 50 50 50 181 168 165 169 173 173 173 173 177 168 165 181 50 50 50 50 50 50 50 50 50 50 50
50 50 50 50 50 50 50 50 50 50 50 50 50 50 88 88 50 50 50 50 50 50 50 50 50 50 50 50 50 50 50 50
50 50 50 50 50 50 50 50 50 50 50 50 50 50 50 50 50 50 50 50 50 50 50 50 50 50 50 50 50 50 50 50
50 50 50 50 50 50 50 50 50 50 50 50 50 50 50 50 50 50 50 50 50 50 50 50 50 50 50 50 50 50 50 50
50 50 50 50 50 50 50 50 50 50 50 50 50 50 50 50 50 50 50 50 50 50 50 50 50 50 50 50 50 50 50 50
50 50 50 50 50 50 50 50 50 50 50 50 50 50 50 50 50 50 50 50 50 50 50 50 50 50 50 50 50 50 50 50
50 50 50 50 50 50 50 50 50 50 50 50 50 50 50 50 50 50 50 50 50 50 50 50 50 50 50 50 50 50 50 50
50 50 50 50 50 50 50 50 50 50 50 50 50 50 50 50 50 50 50 50 50 50 50 50 50 50 50 50 50 50 50 50







